XXXXXXXXXXXXXXXXXXXXXXXXXXXXXXXXXXXXXXXXXXXXXXXX
XXX       XXXXXXXX XXXXXXXXXXXXXXXX             
XXXXXXXXX XXXX     XXXXX            XXXXXXXXXXXX
XXXXXXXXX XXX  XXXXXXXXXXXXXX XXXXXXXXXXXXX XXXX
XXXXXXXXX     XX     X                        XX
XXXXXXXXX XXXXXX XXX XXXXXXXX XXXXXXXXXXXXX XXXX
XXXXXXXXX XXXXXX XX      XXXX X             XXXX
XXXXXX    XXX XX XX XXXXXXXXX X XXXXXXXXXXX XXXX
XXXXXX XXXXXX XX XX XXXXXXXXXXX XXXXXXXXXXX XXXX
XXXX     XXXX XX XX XX    XXXXX           X XXXX
XXXXXXXX XXXX XX XX XX XX XXXXXXXXXXXXXXX XXXXXX
XXXXXXXX XXXX XX XX XX XX                 XXXXXX
XXX      XXXX XX XX XX XXXXXXXXXXXXXXXXXXXXXXXXX
XXX XXXXXXXXX XX XX XX                      X  X
XXX XXXXX     XX XX XXXXXXXXXXXXXXXXXXXXXXX X XX
    XXXXX XXX XX XX                         X XX
XXX XXXX  XXX XX XXXXXXXXXXXXXXXXXXXXXXXXXXXX XX
XXX XXXXX XXX XX                          XXX XX
XXX XXX   XXX XXXXXXXXXXXXXXXXXXXXXXXXXXX XXX XX
XXX XXX XXXX                                  XX
XX      XXXXXXXXXXXXXXXXXXXXXXXXXXXXXXXXXXXXX XX
XXXXXXXXXXXXXXXXXXXXXXXXXXXXXXXXXXXXXX        XX
XXXXXXXXXXXXXXXXXXXXXXXXXXXXXXXXXXXXXXXXXXXXXXXX